      S       S X SS
  S        S    X   
S  S   S    S   X   
  S  S    S   S X  S
             S  X   
     S  S XXXXXXXXXX
S S       X X   X S 
     S S SX XS XXXXX
      XXXXXXXXXXX   
   S  XS  X   X    S
  S   X   X   XS    
      X   X S       
 S  S X  SX     S  S
      W   X  S
          X  S  S   
     S    X         
  S       X S     S 
      XXXXXXXXX     
      X       X S   
      X S  S  X     
